GG........................................................................................GGGGGGGGGGGGGGGGG
G.................................................................................................GGGGGGGGG
G..................................................................................................GGG...GG
G.........................................................................................................G
G........................................................................................................,G
GG.................................................................................................GGG...GG
GGGG...,....................,.....s......,,...............................,................,.,....GGG....GG
GGGGGGGGGGGGGGGGGGGGGGGGGGGGGGGGGGGGGGGGGGGGGGGGGGGGGGGGGGGGGGGGGGGGGGGGGGGGGGGGGGGGGGGGGGGGGGGGGGGGG.....G
GGGGGGGGGGGGGGGGGGGGGGGGGGGGGGGGGGGGGGGGGGGGGGGGGGGGGGGGGGGGGGGGGG*******GGGGGGGGGGGGGGGGGGGGGGGGGGGG.....G
GGGGGGGGGGGGGGGGGGGGGGGGGGGGGGGGGGGGGGGGGGGGGGGGGGGGGGGGGGGGGGGGGGG*****GGGGGGGGGGGGGGGGGGGGGGGGGGGGG.....G
GGGGGGGGGGGGGGGGGGGGGGGGGGGGGGGGGGGGGGGGGGGGGGGGGGGGGGGGGGGGGGGGGGGGG***GGGGGGGGGGGGGGGGGGGGGGGGGGGGG.....G
GGGGGGGGGGGGGGGGGGGGGGGGGGGGGGGGGGGGGGGGGGGGGGGGGGGGGGGGGGGGGGGGGGGGGG*GGGGGGGGGGGGGGGGGGGGGGGGGGGGGG.....G
GGGGGGGGGGGGGGGGGGGGGGGGGGGGGGGGGGGGGGGGGGGGGGGGGGGGGGGGGGGGGGGGGGGGG**GGGGGGGGGGGGGGGGGGGGGGGGGGGGGG.....G
GGGGGGGGGGGGGGGGGGGGGGGGGGGGGGGGGGGGGGGGGGGGGGGGGGGGGGGGGGGGGGGGGGGGG*GGGGGGGGGGGGGGGGGGGGGGGGGGGGGGG.....G
GGGGGGGGGGGGGGGGGGGGGGGGGGGGGGGGGGGGGGGGGGGGGGGGGGGGGGGGGGGGGGGGGGGG**GGGGGGGGGGGGGGGGGGGGGGGGGGGGGGG.....G
GGGGGGGGGGGGGGGGGGGGGGGGGGGGGGGGGGGGGGGGGGGGGGGGGGGGGGGGGGGGGGGGGGGG*GGGGGGGGGGGGGGGGGGGGGGGGGGGGGGGG.....G
