GGGGGGGGGGGGGGGGGGGGGGGGGGGGGGGGGGGGGGGGGGGGGGGGGGGGGGGGGGGGGGGGGGGGGGGGGGGGGGGGGGGGGGGGGGGGGGGGGGGGGGGGGGGGGGGGGGG
GGGGGGGGGGGGGGGGGGGGGGGGGGGGGGGGGGGGGGGGGGGGGGGGGGGGGGGGGGGGGGGGGGGGGGGGGGGGGGGGGGGGGGGGGGGGGGGGGGGGGGGGGGGGGGGGGGG
GGGG......GGGGGGGGG..............GGGGGG...........................................................................G
GG.........GGGGGG.................GGG.............................................................................G
GG.........GGGGGG.................b...............................................................................G
GG.........GGGGGG.................................................................................................G
GG..........b.GG............................,............m......................s............... G................G
G..............G.....,...I.................GGGGGGGGGGGGGGGGGG............,......G................G................G
.....................G........III...GG............w..............GG.....GGG...........GGG......,GG.................
....,...............GG....................................................................,....GGGGG..,.........,,.
GGGGGGGGGGGGGGGGGGGGGG********************************************************************GGGGGGGGGGGGGGGGGGGGGGGGG
GGGGGGGGGGGGGGGGGGGGGGG******************************************************************GGGGGGGGGGGGGGGGGGGGGGGGGG
GGGGGGGGGGGGGGGGGGGGGGG******************************************************************GGGGGGGGGGGGGGGGGGGGGGGGGG
GGGGGGGGGGGGGGGGGGGGGGG******************************************************************GGGGGGGGGGGGGGGGGGGGGGGGGG
GGGGGGGGGGGGGGGGGGGGGGG******************************************************************GGGGGGGGGGGGGGGGGGGGGGGGGG
