GGGGGGGGGGGGGGGGGGG
GGGGGGGGGGGGGGGGGGG
GGGG...........GGGG
GGG.............GGG
GG...............GG
GG...............GG
GG...............GG
GG...............GG
GG...............GG
GG...............GG
GG...............GG
GG.....IIIII.......
GG....IIIIIII......
GGGGGGGGGGGGGGGGGGG
GGGGGGGGGGGGGGGGGGG
